___X_________
_XXX_XXX_XXXX
_______X_____
_XXXXXXXXXXX_
_X___X_______
_X_X_X_XXXXX_
___X_X_X_____
XXXX_X_XXXXX_
___X_X_X___X_
_XXX_X_X_X_XX
_____X___X___
XXXX_XXXXXXX_
___X___X___X_
_X_XXXXX_X_X_
_X_______X___