// . wall
// X ice
// * star block
// ! hidden egg
// O snow bee spawn
// u player spawn

...............
. X   X     X .
. X XXX XX* X .
. X     X   X .
. XXOXXXX XXX .
. X       X X .
. O XX*XXXO ! .
. X   Xu  X X .
. XXX XXX X X .
. X X X   X   .
. X X X XX! X .
.   X   X   X .
. X XXX X XXX .
. X X   X   X .
. X * XXXXX ! .
. X         X .
...............