// X ice
// * star block
// ! hidden egg
// O snow bee spawn
// u player spawn
// _ air

_X___X_____X_
_X_XXX_XX*_X_
_X_____X___X_
_XXOXXXX_XXX_
_X_______X_X_
_O_XX*XXXO_!_
_X___Xu__X_X_
_XXX_XXX_X_X_
_X_X_X___X___
_X_X_X_XX!_X_
___X___X___X_
_X_XXX_X_XXX_
_X_X___X___X_
_X_*_XXXXX_!_
_X_________X_